....................
....................
===.............cc..
......xxxxxxxxxxxx..
....................
===..........c...c..
......xxxxxxxxxxxx..
....................
===.................
.......c.........c..
......xxxxxxxxxxxx..
===.................
....................
p...................
xxxxxxxxxxxxxxxxxxxx