....................
..........=.........
xxx.....=.......jj..
......xxxxxxxxxxxx..
!.............f.f...
xxx..........f.f.f..
......xxxxxxxxxxxx..
...................@
xxx................=
.......j....j....j..
......xxxxxxxxxxxx..
xxx.................
................x...
p..5.7...3..1.......
xxxxxxxxxxxxxxxxxxxx