....................
....................
===..............c..
......xxxxxxxxxxxx..
....................
===..............c..
......xxxxxxxxxxxx..
....................
===.................
.................c..
......xxxxxxxxxxxx..
===.................
....................
p...................
xxxxxxxxxxxxxxxxxxxx