....................
..........=.........
xxx.....=.......cc..
......xxxxxxxxxxxx..
!.............f.f...
xxx..........f.f.f..
......xxxxxxxxxxxx.p
...................@
xxx................=
.......c.........c..
......xxxxxxxxxxxx..
xxx.................
................x...
p..5.7...1..x.......
xxxxxxxxxxxxxxxxxxxx