....................
..........=.........
xxx.....=.......cc..
......xxxxxxxxxxxx..
....................
xxx..........c...c..
......xxxxxxxxxxxx.p
...................@
xxx................=
.......c.........c..
......xxxxxxxxxxxx..
xxx.................
................x...
...5.7...1..x.......
xxxxxxxxxxxxxxxxxxxx