....................
..........=.........
xxx.....=.......cc..
......xxxxxxxxxxxx..
....................
xxx..........c...c..
......xxxxxxxxxxxx..
....................
xxx................=
.......c.........c..
......xxxxxxxxxxxx..
xxx.................
....==..........x...
p........1..x.......
xxxxxxxxxxxxxxxxxxxx