....................
..........=.........
xxx.....=.......cc..
......xxxxxxxxxxxx..
....................
xxx..........c...c..
......xxxxxxxxxxxx..
....................
xxx................=
.......c.........c..
......xxxxxxxxxxxx..
xxx.................
................x...
p..5.7...1..x.......
xxxxxxxxxxxxxxxxxxxx