..........1.........
..........1..4......
xxx....j..1.........
......xxxxxxxxxxxx..
!.............f.f...
xxx..........f.f.f..
......xxxxxxxxxxxx..
..........3........@
xxx.......3........=
.......j..3.........
......xxxxxxxxxxxx..
xxx.................
................x...
p..5.7...3..1.......
xxxxxxxxxxxxxxxxxxxx