....................
....................
xxx.............cc..
......xxxxxxxxxxxx..
....................
xxx..........c...c..
......xxxxxxxxxxxx..
....................
xxx.................
.......c.........c..
......xxxxxxxxxxxx..
xxx.................
....................
p...................
xxxxxxxxxxxxxxxxxxxx