....................
.f....f............3
..............=.....
.......c........=....
.xxxxxxxxxx.......=.
..............5..=..
..............xxx...
!...................
=.......j...........
........xxx........@
...................x
xxxx................
....................
-...c....j..6...j...
xxxxxxxxxxxxxxxxxxxx