....................
....................
....................
c....c....c.........
xxxxxxxxxxxx........
....................
..............xxx...
....................
....................
........xxx.........
....................
xxx.................
....................
p...............c...
xxxxxxxxxxxxxxxxxxxx