....................
....................
...cccc.......=.....
...............=....
xxxxxxxxxxx.......=.
..............5..=..
..............xxx...
!...................
=...................
........xxx........@
...................x
xxxx................
....................
............6.......
xxxxxxxxxxxxxxxxxxxx