.............2......
.......4............
=========...........
........x...........
........x..........3
........x...........
........x..........x
........x..........@
11......x...........
!1......x.......1...
x.......x...........
........x...........
........x...........
....................
xxxxxxxxxxxxxxxxxxxx