f....f...f...2......
.f.f...4j...........
=========...........
........x...........
........x....f.....3
........x...........
........x..........x
........x......f...@
11......x...........
!1......x.......1...
x.......x...........
........x....f......
........x........f..
.........c..........
xxxxxxxxxxxxxxxxxxxx