x...x
xx..x
xxx.x
x.xxx
x...x
xxxxx
xxxxx
.....
xxxxx
xxxxx
x.x.x
x...x
x...x
x...x
x---x