x...................
x...................
x......6............
x...................
x-xxxxxxxxx.........
x5..7...............
xxx.xxxxx=xxxxxx....
!..4........3x......
x=xxxx=======x.....p
x.....=............@
x..................=
xxxx................
x...........=.......
x5666.......651.....
xxxxxxxxxxxxxxxxxxxx