x...................
x...................
x......6............
x...c..c............
x-xxxxxxxxx.........
x5..7........j......
xxx.xxxxx=xxxxxx....
!..4........3x......
x=xxxx=======x......
x.....=............@
x.j................=
xxxx........j.......
x...........=.......
x5666.......651.....
xxxxxxxxxxxxxxxxxxxx